[[1,1,1,1,1,1,1,1],
 [1,3,3,0,10,11,11,1],
 [1,0,4,4,10,12,0,1],
 [1,2,2,5,10,12,0,0],
 [1,0,0,5,0,0,0,1],
 [1,7,6,0,9,9,0,1],
 [1,7,6,8,8,0,0,1],
 [1,1,1,1,1,1,1,1]]