[[1,1,1,1,1,1,1,1],
 [1,3,3,0,12,11,10,1],
 [1,0,0,0,12,11,10,1],
 [1,4,2,2,12,0,9,0],
 [1,4,0,7,8,8,9,1],
 [1,5,5,7,0,0,9,1],
 [1,6,6,7,0,0,0,1],
 [1,1,1,1,1,1,1,1]]