[[1,1,1,1,1,1,1,1],
 [1,0,0,11,11,11,10,1],
 [1,3,0,0,8,9,10,1],
 [1,3,2,2,8,9,10,0],
 [1,3,4,5,7,7,7,1],
 [1,0,4,5,0,0,0,1],
 [1,0,0,6,6,0,0,1],
 [1,1,1,1,1,1,1,1]]