[[1,1,1,1,1,1,1,1],
 [1,3,3,0,0,10,10,1],
 [1,4,0,0,0,8,9,1],
 [1,4,2,2,7,8,9,0],
 [1,5,0,0,7,0,0,1],
 [1,5,0,0,7,0,0,1],
 [1,5,0,0,6,6,0,1],
 [1,1,1,1,1,1,1,1]]