[[1,1,1,1,1,1,1,1],
 [1,0,0,3,3,0,4,1],
 [1,0,0,0,0,0,4,1],
 [1,0,2,2,0,0,4,0],
 [1,0,0,8,6,5,5,1],
 [1,9,0,8,6,0,0,1],
 [1,9,0,0,6,7,7,1],
 [1,1,1,1,1,1,1,1]]