[[1,1,1,1,1,1,1,1],
 [1,3,14,12,12,11,0,1],
 [1,3,14,13,0,11,10,1],
 [1,3,0,13,2,2,10,0],
 [1,4,4,4,5,0,10,1],
 [1,0,0,6,5,9,9,1],
 [1,7,7,6,8,8,0,1],
 [1,1,1,1,1,1,1,1]]