[[1,1,1,1,1,1,1,1],
 [1,0,0,9,9,9,8,1],
 [1,3,0,0,6,7,8,1],
 [1,3,2,2,6,7,8,0],
 [1,3,4,4,0,5,5,1],
 [1,0,10,10,0,0,0,1],
 [1,0,0,11,11,0,0,1],
 [1,1,1,1,1,1,1,1]]