[[1,1,1,1,1,1,1,1],
 [1,5,5,0,3,0,6,1],
 [1,8,0,0,3,4,6,1],
 [1,8,2,2,3,4,9,0],
 [1,8,0,0,0,4,9,1],
 [1,7,0,0,0,0,0,1],
 [1,7,0,0,0,0,0,1],
 [1,1,1,1,1,1,1,1]]