[[1,1,1,1,1,1,1,1],
 [1,3,3,4,0,0,0,1],
 [1,7,0,4,5,5,5,1],
 [1,7,0,2,2,6,0,0],
 [1,0,0,0,0,6,0,1],
 [1,8,8,9,9,9,10,1],
 [1,0,0,0,0,0,10,1],
 [1,1,1,1,1,1,1,1]]