[[1,1,1,1,1,1,1,1],
 [1,0,0,0,0,0,0,1],
 [1,0,0,3,0,8,0,1],
 [1,2,2,3,0,8,9,0],
 [1,4,4,4,0,8,9,1],
 [1,5,6,7,0,10,10,1],
 [1,5,6,7,0,11,11,1],
 [1,1,1,1,1,1,1,1]]